NO ./textures/path_to_the_north_texture.xpm
SO ./textures/path_to_the_south_texture.xpm

EA ./textures/path_to_the_east_texture.xpm
WE ./textures/path_to_the_west_texture.xpm


F 0, 136, 0
C 135, 206, 235

11111111111111111111111
10000000000001000000001
10111111111101011111001
1S100000000000000000001
10111111111011111111001
10000000001000000000001
11111111001111111111101
10000000000000000000001
10111101111101111111001
10100001000001000000001
10101111111111111111001
10100000000000000000001
10111111111111111111001
10000000000000000000001
11111111111111111111111







