NO ./textures/path_to_the_north_texture.xpm
SO ./textures/path_to_the_south_texture.xpm              

WE ./textures/path_to_the_west_texture.xpm
EA ./textures/path_to_the_east_texture.xpm 

F 220,100,0   
C 225,9,3



        111111111111111111111111
       10000000100110000000000001
        10110000011100000000000001      
        1001000000000000000000001
111111111011000001110000000000001
100000000011000001110111111111111
11110111111111011100000010001
11110111111111011101010010001
1000000110101011100000010001
1000000000W000011100000010001
1000000000000001 101010010001
1100000111010101 1110111100111
11110111 1110101 11111010001
1111111 1111111 111111111111
